XXXXXXXXXXXXXXXXXXXXXXXXXXX
XWWWWWWWWWWWWWWWWWWWWWWWWWX
XWFFFFFIFFFFFWFFFFFIFFFFFWX
XWFWWWWFWWWWFWFWWWWFWWWWFWX
XWFWWWWFWWWWFWFWWWWFWWWWFWX
XWIFIFFIFFFFIFIFFFFIFFFFIWX
XWBWWWWFWFWWWWWWWFWFWWWWBWX
XWIFFFFIWFFFFWFFFFWIFFFFFWX
XWWWWWWFWWWWFWFWWWWFWWWWWWX
XWXXXXWFWFFFIFIFFFWFWXXXXWX
XWXXXXWFWFWWWGWWWFWFWXXXXWX
XWWWWWWFWFW0XTX2WFWFWWWWWWX
DDFFFFFIFIWXXTXXWIFIFFFFFDD
XWWWWWWFWFWXX1XXWFWFWWWWWWX
XWXXXXWFWFWWWWWWWFWFWXXXXWX
XWXXXXWFWFFFIPIFFFWFWXXXXWX
XWWWWWWFWWWWFWFWWWWFWWWWWWX
XWFFFFFIWFFFFWFFFFWIFFFFFWX
XWBWWWWFWFWWWWWWWFWFWWWWBWX
XWIFFFFIFFFFIFIFFFFIFFFFIWX
XWFWWWWFWWWWFWFWWWWFWWWWFWX
XWFWWWWFWWWWFWFWWWWFWWWWFWX
XWFFFFFIFFFFFWFFFFFIFFFFFWX
XWWWWWWWWWWWWWWWWWWWWWWWWWX
XXXXXXXXXXXXXXXXXXXXXXXXXXX